.......................................................................................
........................................................................................
......................MMM..................M.................M..........................
.................MMM......M.................M......MMM........M.........F...............
............MMM.............M........MMM......M...............M........MMM..............
.......MMM..................M................M................M......M..................
....MMM........MMM............M........MMM......M........MMM...M....M....................
..P.................M..........M................M................M......................
MMMM............................MMMMMMMMMMM.................MMMMMMMMMMMMMM...............
